11111111
1P0C10C1
1C100011
100E1CC1
11111111
