1111111111
1C1P01C001
1000C100C1
10010EC001
100C000CC1
1111111111
